forward	priorities	minmax	non_miopyc
A	mean	Q(0.9)	max	mean	Q(0.9)	max	mean	Q(0.9)	max	mean	Q(0.9)	max	
10	1873	3690	6757	1827	3713	7232	1897	4010	7504	1982	3962	7051
12	1132	2259	4728	1108	2250	4637	1124	2293	4552	1160	2268	4194
14	829	1754	3690	844	1801	4858	850	1786	4450	839	1770	3432
16	652	1306	2942	666	1340	3128	659	1306	3731	653	1306	2942
18	533	1090	2676	538	1109	2798	545	1109	2735	533	1097	2735
20	485	1054	2506	492	1063	2653	490	1054	2653	482	1046	2613
