    queue	                forward	                priorities	            minmax	                non_miopyc	            preparedness	        district	            ordered
A	mean	Q(0.9)	max	    mean	Q(0.9)	max	    mean	Q(0.9)	max	    mean	Q(0.9)	max	    mean	Q(0.9)	max	    mean	Q(0.9)	max	    mean	Q(0.9)	max	    mean	Q(0.9)	max	
10	1669	3398	8505	1410	2787	7197	1428	2973	7766	1571	3291	8296	1468	2931	7045	1594	3272	12976	2969	6273	12536	3040	6247	11772
12	1130	2349	5768	870	    1640	4469	907	    1823	5065	949	    1918	4714	880	    1660	4250	1036	2186	7808	2193	4601	8400	1899	4081	7863
14	850	    1902	4257	679	    1321	3203	687	    1362	5065	705	    1389	4295	689	    1336	4198	823	    1744	6858	1503	3217	7112	1437	3129	7171
16	655	    1347	4241	549	    1081	2921	557	    1077	4060	559	    1079	4581	543	    1059	2921	684	    1413	4282	1261	2591	5914	974	    2127	5124
18	534	    1059	3251	472	    988	    2418	469	    933	    2230	469	    932	    2308	472	    972	    2418	592	    1155	3251	926	    2052	3943	788	    1690	3898
20	477	    1016	2881	429	    939	    2284	429	    922	    1999	429	    922	    2308	429	    923	    2284	539	    1059	3211	797	    1841	4087	659	    1402	3413
30	287	    562	    1347	272	    512	    1269	273	    509	    1359	273	    516	    1359	273	    518	    1269	375	    671	    2194	555	    1203	3097	580	    1319	3249
