forward	priorities	minmax	non_miopyc
A	mean	Q(0.9)	max	mean	Q(0.9)	max	mean	Q(0.9)	max	mean	Q(0.9)	max	
10	1877	3681	6757	1837	3688	7232	1876	3815	7054	1985	3972	7051
12	1136	2221	4728	1115	2239	4451	1126	2282	4451	1171	2301	4194
14	834	1703	3528	843	1759	3682	844	1734	4089	842	1734	3270
16	661	1340	3373	668	1340	3668	663	1306	3577	655	1329	2901
18	534	1108	2506	534	1091	2653	532	1089	2653	532	1090	2506
20	474	1018	2506	478	1005	2538	477	1004	2461	476	1005	2377
