    queue	                forward	                priorities	            minmax	                non_miopyc	            preparedness	        district	            ordered
A	mean	Q(0.9)	max	    mean	Q(0.9)	max	    mean	Q(0.9)	max	    mean	Q(0.9)	max	    mean	Q(0.9)	max	    mean	Q(0.9)	max	    mean	Q(0.9)	max	    mean	Q(0.9)	max	
10	2281	4599	8931	1809	3523	6904	1894	4205	8966	1950	4542	9559	1886	4093	8109	1753	4001	10342	4062	8318	13589	4213	8356	14916
12	1551	3222	6571	1206	2315	5080	1280	2716	6534	1313	2918	7384	1264	2577	5814	1233	2485	8522	2873	6045	11136	3107	6356	10668
14	1114	2336	5132	902	    1696	3615	964	    1875	5331	994	    2068	5959	929	    1786	4042	940	    1896	7776	2168	4581	8970	2162	4473	8148
16	845	    1781	3910	733	    1409	2866	762	    1489	4081	793	    1563	4455	738	    1421	3444	769	    1524	5146	1627	3397	6844	1516	3259	6628
18	685	    1339	3555	618	    1196	2692	637	    1233	4049	648	    1263	3853	626	    1217	2967	633	    1137	3191	1216	2610	6011	1154	2482	5532
20	591	    1129	3086	531	    1076	2600	536	    1083	3150	539	    1092	3151	534	    1076	2600	571	    1034	2857	931	    2147	4321	930	    2052	4047
30	348	    708	    2811	337	    680	    2154	338	    680	    2154	338	    682	    2154	338	    680	    2154	410	    626	    2220	543	    1095	3157	779	    1677	3372
